15 15
250 250
2 2 2 2 2 2 1 1 1 2 2 2 2 2 2
2 0 0 0 0 0 7 8 0 0 0 0 0 0 2
2 0 0 0 0 0 7 8 0 0 0 0 0 0 2
2 0 0 0 0 0 7 8 0 0 0 0 0 0 2
1 3 3 3 3 3 5 8 0 0 0 0 0 0 2
1 9 9 9 9 9 9 14 9 9 9 12 0 0 2
1 0 0 0 0 0 0 8 0 0 0 8 0 0 2
2 0 0 0 0 0 0 8 0 0 0 8 0 0 2
2 0 0 0 0 0 0 8 0 0 0 8 0 0 1
2 0 0 0 0 0 0 11 9 9 9 14 9 9 1
2 0 0 0 0 0 0 0 0 0 0 8 0 0 1
2 3 3 3 3 3 3 3 3 3 3 8 3 3 2
2 0 0 0 0 0 0 0 0 0 0 8 0 0 2
2 0 0 0 0 0 0 0 0 0 0 8 0 0 2
2 2 2 2 2 2 2 2 2 2 1 1 1 2 2