15 15
250 250
1 1 1 1 1 1 1 1 1 1 1 1 1 1 1
1 0 0 0 0 0 6 7 0 0 0 0 0 0 1
1 0 0 0 0 0 6 7 0 0 0 0 0 0 1
1 0 0 0 0 0 6 7 0 0 0 0 0 0 1
1 2 2 2 2 2 4 7 0 0 0 0 0 0 1
1 8 8 8 8 8 8 13 8 8 8 8 8 8 1
1 0 0 0 0 0 0 7 0 0 0 0 0 0 1
1 0 0 0 0 0 0 7 0 0 0 0 0 0 1
1 0 0 0 0 0 0 10 8 8 8 11 0 0 1
1 0 0 0 0 0 0 0 0 0 0 7 0 0 1
1 0 0 0 0 0 0 0 0 0 0 7 0 0 1
1 2 2 2 2 2 2 2 2 2 2 7 2 2 1
1 0 0 0 0 0 0 0 0 0 0 7 0 0 1
1 0 0 0 0 0 0 0 0 0 0 7 0 0 1
1 1 1 1 1 1 1 1 1 1 1 1 1 1 1